1111111111
1P000M00E1
100C0M0CM1
100M000001
1M0000C001
100C000M01
1111111111