111111
1P0011
100001
1000C1
1100E1
111111